WWWWWWWWWWWWWWWWWWWWWWWW
WWWWWWWPHPPPWWWWWWWWWWWW
WWWWPPPPWWPPWWWWWWWWWWWW
WWWWPWWPWWPPWWWWWPPPPPPS
WWWWPWWPWWPPWWWWWHWWWWWW
WWWWHWWPWWPPPWWWPPWWWWWW
WWWWPWWWWWPPHWWWPWWWWWWW
FPPPPWWWWWWWPPPPPWWWWWWW
WWWWWWWWWWWWWWWWWWWWWWWW
WWWWWWWWWWWWWWWWWWWWWWWW
WWWWWWWWWWWWWWWWWWWWWWWW
WWWWWWWWWWWWWWWWWWWWWWWW