WWFWW
WWPWW
WPPPW
WPPPW
WWPWW
WWSWW